NO ./asset/xpm/wall02_north.xpm
SO        ./asset/xpm/wall02_south.xpm
WE ./asset/xpm/wall02_west.xpm
EA ./asset/xpm/wall02_east.xpm

F   220,100,0
C   225,30,0

1111111111111111111111111
1000000000110000000000001
1011000001110000000000001
1001000000000000000000001
1111111110110000011100001
1000000000110000011101111
1111010000000001110000001
1111011000000001110101001
1100000011010101110010001
1000000000001100000010001
1000000000001101010010001
1100111101011111011010111
1110111001110101111010001
1111111111111111111111111
