NO ./asset/xpm/wall02_north.xpm
SO        ./asset/xpm/wall02_south.xpm
WE ./asset/xpm/wall02_west.xpm
EA ./asset/xpm/wall02_east.xpm

F   220,100,0
C   137,189,222

1111111111111111111111111
1000000000110000000000001
1011000001110000000N000011111
10010000000000000000000000001
11111111101100000000000000001
10000000001100000000111111111
111101000000000000000001
111101100000000000101001
1100000011010100010000001
10000000000011000000100011111111
10000000000011010100100000000001
11001111010111110110101111111111
1110111001110101111010001
1111111111111111111111111
